NO ./textures/wall0.xpm
SO ./textures/wall1.xpm
WE ./textures/wall2.xpm
EA ./textures/wall3.xpm
F 220,100,0
C 225,30,0
1111111111111111111111
1000000001101000000001
1000000001101000000001
1000000001011000000001
1000000001011000000001
1100010000000000011111
1101010000000000010001
1101010000S00000011001
1010100000000000011111
1000000001111000000001
1000000001000000000001
1000000001111000000001
1000000000001000000001
1000000001111000000001
1111111111111111111111
