NO ./textures/wall0.xp
SO ./textures/wall1.xpm
WE ./textures/wall2.xpm
EA ./textures/wall3.xpm
F 220,100,0
C 225,30,0
1111111111111111111111111
1000000000000000000000001
10000N0000000000000000001
1000000000000000000000000111
10000000000000001101010010001
110000011101010111110111100111
11110111 1110101 101111010001
11111111 1111111 111111111111
