NO ./path_to_the_north_texture
SO ./path_to_the_south_texture
WE ./path_to_the_west_texture
EA ./path_to_the_east_texture
F 220,100,0
C 225,30,0
1111111111111111111111111
1000000000000000000000001
10000N0000000000000000001
100100000000000000000000111111111
11111111101100000000000000000001
1000000000110000000000111111111
11110000000000000000000010001
11110000000000000001010010001
11000000110000000000000010001
10000000000000001100000000001
10000000000000001101010010001
110000011101010111110111100111
11110111 1110101 101111010001
11111111 1111111 111111111111
