NO ./textures/wall0.xpm
SO ./textures/wall1.xpm
WE ./textures/wall2.xpm
EA ./textures/wall3.xpm
F 89, 48, 15
C 135, 206, 235
111111111111
1N0000000001 111111111111111111
100000000001 100000000000000001 11111111111111111111111111111111
100000000001 100000000000000001 10000000000000000000000000000001
100000000001 100000000000000001 10000000000000000000000000000001
111111000001 100000000000000001 10000000000000000000000000000001
     1000001 100000000000000001 10000000000000000000000000000001
     1000001 100000000000000001 10000000000000000000000000000001
111111000001 100000000000000001 10000000000000000000000000000001
1000011111011100011111111111111 10000000000000000000000000000001
100001   100000001              10000000000000000000000000000001
100001   100000001111111111111111011111111111111111111111111111111111111111111111
100001   100000000000000000000000000000000000000000001000000000000000000000000001
111011   100000001111111111111111000000000000000000001000000000000000000000000001
10001    100000001              1000000000000000000001000000000000000001110000001
10111    100000001              1000000000000000000001111111111111111111000000001
101111111100000001              1000000000000000000000000000000000000000000000001
101000000000000001              1000000000000000000000000000000000000000000000001
101000000000000001              1000000000000000000000000000000000000000000000001
100000000000000001              1000000000000000000000000000000000000000000000001
100000000000000001111111111111111111111111111111111111111111111111111111111111111
1000000000000000000000000000000000000000000000001
1000000000000000000000000000000000000000000000001
1000000000000000000000000000000000000000000000001
1000000000000000001110000000000000000000000000001
1000000000000000001 10000000000000000000000000001
1000000000000000001110000000000000000000000000001
1000000000000000000000000000000000000000000000001
1000000000000000000000000000000000000000000000001
1111111111111111111111111111111111111111111111111
