NO ./textures/wall0.xpm
SO ./textures/wall1.xpm
WE ./textures/wall2.xpm
EA ./textures/wall3.xpm
F 220,100,0
C 225,30,0
11111111111111111111111111111111111111111111111111111111111111111111111111111111111111111111111111111111111111111111111111111
10000000000000000000000000000000000000000000000000000000000000000000000000000000000000000000000000000000000000000000000000001
10000N000000000000000000000111111111111111111111100000011111100000000000000000000000000000000000000000000000111111111111111111111111111111111111
10000000000000000000000001110000000000000000000011111111111111111111110000011111111111111111111110000000110000000000000000000000000000000000011
1000000000000000110101001000100000000000000000000000000000000000000000000000000000000111100000000000000000000000000000000000111111111111111111111111
1000000111111111111111111111100000000000000000111111110000000000000000000001111100000000000000000000000000000000001111111111111111111111
10000N000000000000000000000000000000000000000000000000000011111111111111111111110000000000000011111000000000000000000000000000000000001
10000000000000000000000000000000000000111111111111111111111100000000000000000000000011111111111111111111110000000000000000000000111111
10000011111111111111111111110000001110000000000000000000000000000000000000000000000000000000001100000000000000000000000111111111111
100000000000000011010100100111111111111111100000000000000000000000000000111100000000000000000000000000000000000111111111111111111
100000000000000000000000000000000000111111111111111111111100000000000000000000000000000001111100000000000000000000000000000000001
10000N000000001111111111111111111111000000000000001111111111111111111111000000001111100000000000000000000000000000000000111111111
10000000000000000000000001110000000000000000000000000000000000000000000000000000000011111100001111111111111111111111111111111111
10000000000000001101010010001000000000000000000000000000000000000000000000000000000000000000000000000000000000000000000000001
11111111111111111111111111111111111111111111111111111111111111111111111111111111111111111111111111111111111111111111111111111
