NO ./textures/wall0.xpm
SO ./textures/wall1.xpm
WE ./textures/wall2.xpm
EA ./textures/wall3.xpm
F 220,100,0
C 225,30,0
11111111111111111111111111111111111111111111111111111111111111111111111111111111111111111111111111111111111111111111111111111
10000000000000000000000000000000000000000000000000000000000000000000000000000000000000000000000000000000000000000000000000001
10000N00000000000000000000000000000000000000000000000000000000000000000000000000000000000000000000000000000000000000000000001
1000000000000000000000000111000000000000000000000000000000000000000000000000000000000110000000000000000000000000000000000011
10000000000000001101010010001000000000000000000000000000000000000000000000000000000001111000000000000000000000000000000000001
10000000000000000000000000000000000000000000000000000000000000000000000000000000000001111100000000000000000000000000000000001
10000N00000000000000000000000000000000000000000000000000000000000000000000000000000011111000000000000000000000000000000000001
100000000000000000000000011100000000000000000000000000000000000000000000000000000000111111000000000000000000000000000000000001
10000000000000001101010010001000000000000000000000000000000000000000000000000000000000000000000000000000000000000000000000001
11111111111111111111111111111111111111111111111111111111111111111111111111111111111111111111111111111111111111111111111111111

